111111111111111111
1000000000001C1001
100000000000010001
1P0000000000000E01
111111111111111111
