111111111111111111
100000000000100001
1P0000C00001000E01
111111111111111111
