1111111111111
10010C0000001
100C011111001
1PCE1E00C0001
1111111111111
