1111111111111111111111111111111111
100000000000000C00000C000000000001
1010010100100000101001000000010101
10100100101010100010010000S0010101
1000000S0C00C0P00000000000000000C1
1010010100100000101001000000010101
1010010100100000101001000000010101
100000000000000C00000C0E0000000001
1010010100100000101001000000010101
1010010010101010001001000000010101
10000S000C00C01000000000000S0000C1
1010010100100000101001000000010101
1010010100100000101001000000010101
100000000000000C00000C000000000001
1010010100100000101001000000010101
1010010010101010001001000000010101
100000S00C00C01000000000S0000000C1
1111111111111111111111111111111111
